NO ./home/ayboudya/Desktop/lst_cube/textures/149.xpm
SO ./home/ayboudya/Desktop/lst_cube/textures/149.xpm
WE ./home/ayboudya/Desktop/lst_cube/textures/153.xpm
EA ./home/ayboudya/Desktop/lst_cube/textures/176.xpm

F 20,20,200
F 20,20,200
C 2,10,20

 111111111111111111111
1111111111111111111111
1000000000000000000001
1000000E10000000000001
1000000100000000000011
11111111111111111111