NO ./textures/149.xpm
SO ./textures/149.xpm
WE ./textures/153.xpm              
EA ./textures/176.xpm

C 100,0,20

F 200,20,0

111111111111111111111          
1111111111111111111111
1000000000000000000001
1000000E10000000000001
1000000100000000000011
11111111111111111111
1
1
1
